1111111111111111111111
1000000000000000000001
100CCCCCC0000CCCCCC001
10CC00000000CC00000001
10CC00000000CC00000001
10CC0P0CCC00CC0E0CCC01
10CC000CC000CC000CC001
10CC000CC000CC000CC001
100CCCCC00000CCCCC0001
1000000000000000000001
1111111111111111111111