11111111111111
10CCCC00CC0001
10C00C00C0C001
10C00C00C00C01
10CCCCE0C00C01
10C00000C00C01
10C00000C0C001
1PC00000CC0001
11111111111111