11111111111
10C01C001E1
10101010101
1P100010C01
11111111111
