11111111111
10C000C0001
10P0E000001
11111111111
